##################################################
#                                                #
#   #####  #####  #####     #    ######  ######  #
#   #      #          #    #     #       #       #
    #      #####    #     #  #   ######  ####     
#   #          #   #     ######  #ooooo  #       #
#   #####  #####  #####      #   ######  ######  #
#                                                #
#                           #####                #
#   ###    #### #   ######    #   ###   ## #     #
#               #         #   S                  #
##################################################
